1111111111111
1P000000000C1
1000000000001
100000E000001
100000E000001
100000E000001
11111111E0001
100000E000001
100000E000001
100000E000001
1111111111111
