11111111111111111111111111111111111
10A00000000000000000000000000000001
1000000000000C000000000000000000001
10000000000000000000000000000000001
1000111100001111001111111111110E001
10001111000011110011111111111100001
10001111000011110011110A00111100001
10001111000011110011110000111100001
10001111111111110000000011110000001
1000111111111111000000111100000P001
10000000000011110000111100000000001
100C0000000011110011110000111100001
100A0C00000011110011111111111100001
10000C00000011110011111111111100001
10000000000000000000000000000000001
10000A0000C00000000000000C000000001
10000000000000000000000000000000001
11111111111111111111111111111111111
