1111111111111
1C0C0000000C1
1C00000000001
100000E000001
1111111111111
