1111111111111
1C0C0000000C1
1C11011101001
1P1001E101001
1111111111111
