1111111111111
1CXC0000000C1
1C00000000001
1P0000E000001
1111111111111
