1111111111111
1C0C0000010C1
1C00000001001
1P0000E001001
1111111111111
