1111111111111
1C0C0000A00C1
1C00000000001
1P0000E000001
1111111111111
